WWWWWWWWWWWWWWWWWWWWWWWWWWWWWW
WWWWBBBBBBBWBBBSWBBBKWBBBBBBBW
WWGBBBBBBCKWBBBBWBABBWBBGBBBBW
WWBBBBGBBBBWBABBWBBBBWBCBWBBBW
WWBBBWWWWWWWWWDWWWWDWWBBBWBABW
WABBWWBBBBBBBBBBBCBBBBBBBWBBBW
WBBBWBBBBBBBBBBBBBBBBBBBBWBBBW
WWBBBBBWWWBGGGGGBBBBBBGBBWBBBW
WWBBBBBBBWWWWWWWGBBABWWWWWWWDW
WWWBBWBBBGGWWBBWWBBBBBBBBBBWBW
WBBBBWBBBBBGWBVBWWBBBCMBGBBWBW
WBBCBWBBCABGWWBBBWBBBBBCBBBWBW
WBBBBWBBBBBBGWBBBWGBBBBBBBKWBW
WBBBBWBCBBBBGWBBBWWWWWWWWWWWBW
WWBBBWBGBBBBGWWBBCBBBBBBBBBBBW
WWBBGWBBCBBBBBWBBBBBWWWDWWWWWW
WWBBBWBBBBABBBWWWWWBWBBCBGBBBW
WWBBBWBBBBBBBBBABBWWWBBBBBBCBW
WWBBBWWWWWWWWWWWWWWGWBBBCBBBAW
WWBBWWBBBBBCBBBBBBBMBBBBGBBBBW
WBBBBBBBBBCBCBGBBBBBWBBBBBCBBW
WBBBBBWWWWWWWBBBWWWWWWWBBBBMBW
WBBBWWWBBBBGWBBBBBBBBBBCBBBBBW
WBPBBLBBGBBAWBBBBBABBBBBBBBBBW
WWWWWWWWWWWWWWWWWWWWWWWWWWWWWW